空空空空空空空空空空空空空
空空空空空空空空空空空空空
空空空空空空空空空空空空空
空空空空空空空空空空空空空
空空空空空空空空空空空空空
空空空空空空空空空空空空空
空空空空空空空空空空空空空
空空空空空空空空空空空空空
空空空空空空空空空空空空空
空空砖砖砖砖砖砖砖砖砖空空
空空空空空空空空空空空空空
空空空空空空空空空空空空空
空空空空空空空空空我空空空